Drop Off Location,Stake,Route Number/Name,Time Spent Collecting Donations,# of Adult Volunteers who participated in this route,# of Youth Volunteers who participated in this route,# of Doors in Route,# of Donation Bags Collected,total number of volunteers ,New Route Number/Name,TotalRoutes,AvgDoorsPerRoute,TotalDonationVolume,TotalVolunteers
Bearspaw Chapel,Riverbend Stake,676,15,7,7,78,599,14,Riverbend Stake 1,94,78,599,14
Bearspaw Chapel,Gateway Stake,0,15,0,0,0,0,0,Gateway Stake 1,82,0,0,0
Londonberry Chapel,Bonnie Doon Stake,Unassigned,15,1,0,1,1,1,Bonnie Doon Stake 1,104,1,1,1
Gateway Stake Centre ,Gateway Stake,50,15,2,2,20,20,4,Gateway Stake 2,82,20,20,4
Bonnie Doon Stake Centre,Bonnie Doon Stake,98,15,2,2,20,15,4,Bonnie Doon Stake 2,104,20,15,4
Bearspaw Chapel,Gateway Stake,6,45,2,3,144,25,5,Gateway Stake 3,82,144,25,5
Gateway Stake Centre ,Gateway Stake,19,45,1,0,230,21,1,Gateway Stake 4,82,230,21,1
Bonnie Doon Stake Centre,Bonnie Doon Stake,7,15,2,0,75,7,2,Bonnie Doon Stake 3,104,75,7,2
Gateway Stake Centre ,Gateway Stake,Meyokumin 25,45,2,0,280,32,2,Gateway Stake 5,82,280,32,2
Londonberry Chapel,Bonnie Doon Stake,32,45,2,3,21,23,5,Bonnie Doon Stake 4,104,21,23,5
Riverbend Stake Centre,Riverbend Stake,Route 1,1,3,3,45,15,6,Riverbend Stake 2,94,45,15,6
Riverbend Stake Centre,Riverbend Stake,2,45,2,4,172,18,6,Riverbend Stake 3,94,172,18,6
Bearspaw Chapel,Gateway Stake,1,15,2,0,135,26,2,Gateway Stake 6,82,135,26,2
Bonnie Doon Stake Centre,Bonnie Doon Stake,Strathearn North,45,2,4,0,30,6,Bonnie Doon Stake 5,104,0,30,6
Londonberry Chapel,Bonnie Doon Stake,64,15,2,0,18,18,2,Bonnie Doon Stake 6,104,18,18,2
Londonberry Chapel,Bonnie Doon Stake,21,15,2,1,10,12,3,Bonnie Doon Stake 7,104,10,12,3
Bearspaw Chapel,Gateway Stake,10,45,2,3,3,36,5,Gateway Stake 7,82,3,36,5
Gateway Stake Centre ,Gateway Stake,28/konietz,45,3,4,117,30,7,Gateway Stake 8,82,117,30,7
Bonnie Doon Stake Centre,Bonnie Doon Stake,58,15,2,1,125,7,3,Bonnie Doon Stake 8,104,125,7,3
Bearspaw Chapel,Gateway Stake,6,45,2,1,12,20,3,Gateway Stake 9,82,12,20,3
Gateway Stake Centre ,Gateway Stake,18,15,2,0,236,16,2,Gateway Stake 10,82,236,16,2
Riverbend Stake Centre,Riverbend Stake,6,45,3,2,50,8,5,Riverbend Stake 4,94,50,8,5
Edmonton North Stake Centre,Edmonton North Stake,Caernarvon A,45,2,3,215,38,5,Edmonton North Stake 1,41,215,38,5
Gateway Stake Centre ,Gateway Stake,30,1,3,0,340,30,3,Gateway Stake 11,82,340,30,3
Bonnie Doon Stake Centre,YSA Stake,Ritchie 4,45,3,0,66,15,3,YSA Stake 1,3,66,15,3
Bonnie Doon Stake Centre,YSA Stake,Mill Creek 2,45,1,0,208,12,1,YSA Stake 2,3,208,12,1
Bearspaw Chapel,Riverbend Stake,7,45,2,0,174,23,2,Riverbend Stake 5,94,174,23,2
Bonnie Doon Stake Centre,Bonnie Doon Stake,Fulton Place #1B,15,2,0,100,12,2,Bonnie Doon Stake 9,104,100,12,2
Bonnie Doon Stake Centre,YSA Stake,Mill Creek 2,45,1,0,208,12,1,YSA Stake 3,3,208,12,1
Bonnie Doon Stake Centre,Bonnie Doon Stake,Sloan,15,2,2,167,20,4,Bonnie Doon Stake 10,104,167,20,4
Riverbend Stake Centre,Riverbend Stake,37,15,2,0,100,10,2,Riverbend Stake 6,94,100,10,2
Riverbend Stake Centre,Riverbend Stake,13,15,1,2,100,6,3,Riverbend Stake 7,94,100,6,3
Londonberry Chapel,Bonnie Doon Stake,169,15,1,2,30,22,3,Bonnie Doon Stake 11,104,30,22,3
Bearspaw Chapel,Gateway Stake,9,45,2,1,148,28,3,Gateway Stake 12,82,148,28,3
Edmonton North Stake Centre,Edmonton North Stake,3-3-1a,15,1,0,0,12,1,Edmonton North Stake 2,41,0,12,1
Riverbend Stake Centre,Riverbend Stake,3,45,1,2,169,11,3,Riverbend Stake 8,94,169,11,3
Londonberry Chapel,Bonnie Doon Stake,46,15,1,3,7,10,4,Bonnie Doon Stake 12,104,7,10,4
Londonberry Chapel,Bonnie Doon Stake,49th street,120,2,0,40,15,2,Bonnie Doon Stake 13,104,40,15,2
Londonberry Chapel,Bonnie Doon Stake,2,15,1,0,60,17,1,Bonnie Doon Stake 14,104,60,17,1
Gateway Stake Centre ,Gateway Stake,Laurel Park,45,4,0,116,50,4,Gateway Stake 13,82,116,50,4
Londonberry Chapel,Bonnie Doon Stake,169,15,2,2,99,24,4,Bonnie Doon Stake 15,104,99,24,4
Bearspaw Chapel,Gateway Stake,9,45,2,2,161,56,4,Gateway Stake 14,82,161,56,4
Bonnie Doon Stake Centre,Bonnie Doon Stake,Terrace Heights #3 (Poll 66),15,2,2,75,8,4,Bonnie Doon Stake 16,104,75,8,4
Londonberry Chapel,Bonnie Doon Stake,25,45,2,0,13,14,2,Bonnie Doon Stake 17,104,13,14,2
Bearspaw Chapel,Gateway Stake,7,15,2,0,170,30,2,Gateway Stake 15,82,170,30,2
Bonnie Doon Stake Centre,Bonnie Doon Stake,Ritchie 2,15,2,0,194,21,2,Bonnie Doon Stake 18,104,194,21,2
Londonberry Chapel,Bonnie Doon Stake,16,45,2,3,15,18,5,Bonnie Doon Stake 19,104,15,18,5
Bearspaw Chapel,Gateway Stake,33,45,4,3,109,21,7,Gateway Stake 16,82,109,21,7
Gateway Stake Centre ,Gateway Stake,8,45,1,0,12,11,1,Gateway Stake 17,82,12,11,1
Riverbend Stake Centre,Riverbend Stake,25,45,2,1,280,40,3,Riverbend Stake 9,94,280,40,3
Bonnie Doon Stake Centre,Bonnie Doon Stake,42,15,1,3,150,12,4,Bonnie Doon Stake 20,104,150,12,4
Edmonton North Stake Centre,Edmonton North Stake,5 2.2,45,2,0,217,13,2,Edmonton North Stake 3,41,217,13,2
Londonberry Chapel,Bonnie Doon Stake,182,15,1,0,10,12,1,Bonnie Doon Stake 21,104,10,12,1
Riverbend Stake Centre,Riverbend Stake,54,1,2,2,191,30,4,Riverbend Stake 10,94,191,30,4
Bonnie Doon Stake Centre,Bonnie Doon Stake,Goldbar 5,15,1,4,115,4,5,Bonnie Doon Stake 22,104,115,4,5
Gateway Stake Centre ,Gateway Stake,11,15,2,3,180,19,5,Gateway Stake 18,82,180,19,5
Bearspaw Chapel,Gateway Stake,8,1,1,1,156,50,2,Gateway Stake 19,82,156,50,2
Edmonton North Stake Centre,Edmonton North Stake,4-3.2,1,1,1,200,35,2,Edmonton North Stake 4,41,200,35,2
Bearspaw Chapel,Gateway Stake,13,45,2,0,20,35,2,Gateway Stake 20,82,20,35,2
Gateway Stake Centre ,Gateway Stake,30,45,2,165,165,18,167,Gateway Stake 21,82,165,18,167
Gateway Stake Centre ,Gateway Stake,5,15,1,0,1,10,1,Gateway Stake 22,82,1,10,1
Edmonton North Stake Centre,Edmonton North Stake,4-1.1,1,2,0,170,32,2,Edmonton North Stake 5,41,170,32,2
Edmonton North Stake Centre,Edmonton North Stake,Calder C,45,1,2,60,20,3,Edmonton North Stake 6,41,60,20,3
Bearspaw Chapel,Gateway Stake,63,45,1,2,140,12,3,Gateway Stake 23,82,140,12,3
Bearspaw Chapel,Gateway Stake,36,45,2,3,134,55,5,Gateway Stake 24,82,134,55,5
Gateway Stake Centre ,Gateway Stake,73,15,1,4,128,7,5,Gateway Stake 25,82,128,7,5
Bearspaw Chapel,Gateway Stake,8,45,1,1,156,50,2,Gateway Stake 26,82,156,50,2
Riverbend Stake Centre,Riverbend Stake,21,15,2,2,100,12,4,Riverbend Stake 11,94,100,12,4
Londonberry Chapel,Bonnie Doon Stake,134,15,2,0,125,20,2,Bonnie Doon Stake 23,104,125,20,2
Bonnie Doon Stake Centre,Bonnie Doon Stake,1,1,3,0,195,40,3,Bonnie Doon Stake 24,104,195,40,3
Londonberry Chapel,Bonnie Doon Stake,3,45,0,2,177,19,2,Bonnie Doon Stake 25,104,177,19,2
Edmonton North Stake Centre,Bonnie Doon Stake,Ottwell #3 (poll 48),1,1,1,200,30,2,Bonnie Doon Stake 26,104,200,30,2
Londonberry Chapel,Bonnie Doon Stake,22,1,1,1,0,51,2,Bonnie Doon Stake 27,104,0,51,2
Bearspaw Chapel,Gateway Stake,6,15,1,0,4,1,1,Gateway Stake 27,82,4,1,1
Gateway Stake Centre ,Gateway Stake,74,45,2,0,140,21,2,Gateway Stake 28,82,140,21,2
Riverbend Stake Centre,Riverbend Stake,Royal Gardens # / Gavin Speidwl,45,2,2,100,40,4,Riverbend Stake 12,94,100,40,4
Edmonton North Stake Centre,Edmonton North Stake,"113A, 133 street 131 ave",15,2,0,80,6,2,Edmonton North Stake 7,41,80,6,2
Gateway Stake Centre ,Gateway Stake,52 and 52,45,1,1,250,25,2,Gateway Stake 29,82,250,25,2
Gateway Stake Centre ,Gateway Stake,41,15,3,0,100,20,3,Gateway Stake 30,82,100,20,3
Edmonton North Stake Centre,Edmonton North Stake,5,120,5,10,1000,56,15,Edmonton North Stake 8,41,1000,56,15
Bonnie Doon Stake Centre,Bonnie Doon Stake,Poll 47,15,2,2,150,18,4,Bonnie Doon Stake 28,104,150,18,4
Riverbend Stake Centre,Riverbend Stake,AG1,45,2,2,140,50,4,Riverbend Stake 13,94,140,50,4
Riverbend Stake Centre,Riverbend Stake,5,15,1,2,125,28,3,Riverbend Stake 14,94,125,28,3
Bearspaw Chapel,Gateway Stake,56,45,2,3,130,35,5,Gateway Stake 31,82,130,35,5
Gateway Stake Centre ,Gateway Stake,86/laurel,1,2,0,130,16,2,Gateway Stake 32,82,130,16,2
Gateway Stake Centre ,Gateway Stake,66,15,1,0,1,2,1,Gateway Stake 33,82,1,2,1
Bonnie Doon Stake Centre,Bonnie Doon Stake,Forest height #4 (poll 68),1,2,2,200,23,4,Bonnie Doon Stake 29,104,200,23,4
Londonberry Chapel,Bonnie Doon Stake,58,45,2,0,40,26,2,Bonnie Doon Stake 30,104,40,26,2
Edmonton North Stake Centre,Edmonton North Stake,Hudson c,45,2,0,166,20,2,Edmonton North Stake 9,41,166,20,2
Gateway Stake Centre ,Gateway Stake,23,45,2,2,210,20,4,Gateway Stake 34,82,210,20,4
Bearspaw Chapel,Riverbend Stake,19,45,2,2,205,21,4,Riverbend Stake 15,94,205,21,4
Londonberry Chapel,Bonnie Doon Stake,197/210,120,2,0,0,9,2,Bonnie Doon Stake 31,104,0,9,2
Gateway Stake Centre ,Gateway Stake,36,45,4,2,173,17,6,Gateway Stake 35,82,173,17,6
Bearspaw Chapel,Bonnie Doon Stake,6,45,2,0,150,40,2,Bonnie Doon Stake 32,104,150,40,2
Bearspaw Chapel,Gateway Stake,18,45,2,2,155,22,4,Gateway Stake 36,82,155,22,4
Gateway Stake Centre ,Gateway Stake,24,45,2,2,200,35,4,Gateway Stake 37,82,200,35,4
Bearspaw Chapel,Gateway Stake,46,45,2,0,154,28,2,Gateway Stake 38,82,154,28,2
Bearspaw Chapel,Bonnie Doon Stake,125,45,2,0,128,12,2,Bonnie Doon Stake 33,104,128,12,2
Londonberry Chapel,Bonnie Doon Stake,123,45,1,2,230,42,3,Bonnie Doon Stake 34,104,230,42,3
Gateway Stake Centre ,Gateway Stake,12,45,2,0,131,20,2,Gateway Stake 39,82,131,20,2
Gateway Stake Centre ,Gateway Stake,2,15,1,2,100,20,3,Gateway Stake 40,82,100,20,3
Riverbend Stake Centre,Riverbend Stake,Howard Biggs,45,2,3,150,30,5,Riverbend Stake 16,94,150,30,5
Edmonton North Stake Centre,Edmonton North Stake,3-2.4b,15,2,0,1751,14,2,Edmonton North Stake 10,41,1751,14,2
Bearspaw Chapel,Gateway Stake,63,1,1,3,169,20,4,Gateway Stake 41,82,169,20,4
Bearspaw Chapel,Gateway Stake,15,1,2,2,153,35,4,Gateway Stake 42,82,153,35,4
Riverbend Stake Centre,Riverbend Stake,9,1,2,0,150,20,2,Riverbend Stake 17,94,150,20,2
Bonnie Doon Stake Centre,Bonnie Doon Stake,Strathcona,45,2,0,151,18,2,Bonnie Doon Stake 35,104,151,18,2
Gateway Stake Centre ,Gateway Stake,1,45,3,0,241,50,3,Gateway Stake 43,82,241,50,3
Riverbend Stake Centre,Riverbend Stake,Gurney,45,2,0,187,45,2,Riverbend Stake 18,94,187,45,2
Gateway Stake Centre ,Gateway Stake,"19,23",120,2,3,280,48,5,Gateway Stake 44,82,280,48,5
Edmonton North Stake Centre,Edmonton North Stake,Cumberland E,15,2,2,180,15,4,Edmonton North Stake 11,41,180,15,4
Londonberry Chapel,Bonnie Doon Stake,"162 , 170",45,1,1,300,54,2,Bonnie Doon Stake 36,104,300,54,2
Gateway Stake Centre ,Gateway Stake,"62, 48, 61",1,4,1,431,37,5,Gateway Stake 45,82,431,37,5
Bearspaw Chapel,Gateway Stake,17,45,2,2,100,25,4,Gateway Stake 46,82,100,25,4
Gateway Stake Centre ,Gateway Stake,37,1,3,1,230,21,4,Gateway Stake 47,82,230,21,4
Londonberry Chapel,Bonnie Doon Stake,52,45,2,1,300,55,3,Bonnie Doon Stake 37,104,300,55,3
Edmonton North Stake Centre,Edmonton North Stake,2-1.1,45,5,4,286,29,9,Edmonton North Stake 12,41,286,29,9
Londonberry Chapel,Bonnie Doon Stake,Not specified ,45,1,4,29,29,5,Bonnie Doon Stake 38,104,29,29,5
Bonnie Doon Stake Centre,Bonnie Doon Stake,Strathcona 2 134 housew,45,2,3,90,12,5,Bonnie Doon Stake 39,104,90,12,5
Gateway Stake Centre ,Gateway Stake,69/71,45,4,1,271,27,5,Gateway Stake 48,82,271,27,5
Londonberry Chapel,Bonnie Doon Stake,17,45,2,0,0,20,2,Bonnie Doon Stake 40,104,0,20,2
Riverbend Stake Centre,Riverbend Stake,201,1,2,2,242,26,4,Riverbend Stake 19,94,242,26,4
Bearspaw Chapel,Gateway Stake,23,15,1,3,155,22,4,Gateway Stake 49,82,155,22,4
Londonberry Chapel,Bonnie Doon Stake,15,45,2,0,15,15,2,Bonnie Doon Stake 41,104,15,15,2
Gateway Stake Centre ,Gateway Stake,4,15,2,4,198,33,6,Gateway Stake 50,82,198,33,6
Bonnie Doon Stake Centre,Bonnie Doon Stake,Forest Heights #7 (poll 71) A,45,2,0,75,15,2,Bonnie Doon Stake 42,104,75,15,2
Gateway Stake Centre ,Gateway Stake,6,1,2,2,168,16,4,Gateway Stake 51,82,168,16,4
Gateway Stake Centre ,Gateway Stake,26,45,2,2,25,250,4,Gateway Stake 52,82,25,250,4
Riverbend Stake Centre,Riverbend Stake,51,45,2,0,97,15,2,Riverbend Stake 20,94,97,15,2
Bearspaw Chapel,Gateway Stake,2,45,2,2,130,20,4,Gateway Stake 53,82,130,20,4
Riverbend Stake Centre,Riverbend Stake,3,1,2,0,200,70,2,Riverbend Stake 21,94,200,70,2
Londonberry Chapel,Bonnie Doon Stake,110,45,6,0,190,26,6,Bonnie Doon Stake 43,104,190,26,6
Londonberry Chapel,Bonnie Doon Stake,54,45,1,0,20,24,1,Bonnie Doon Stake 44,104,20,24,1
Edmonton North Stake Centre,Edmonton North Stake,Carlisle B,1,2,0,150,33,2,Edmonton North Stake 13,41,150,33,2
Londonberry Chapel,Bonnie Doon Stake,141,15,1,1,0,18,2,Bonnie Doon Stake 45,104,0,18,2
Londonberry Chapel,Bonnie Doon Stake,29,45,2,3,16,16,5,Bonnie Doon Stake 46,104,16,16,5
Bonnie Doon Stake Centre,Bonnie Doon Stake,Fulton Place #4 (poll 74),45,2,3,250,39,5,Bonnie Doon Stake 47,104,250,39,5
Edmonton North Stake Centre,Edmonton North Stake,3-1.2.b,45,2,0,152,23,2,Edmonton North Stake 14,41,152,23,2
Bearspaw Chapel,Gateway Stake,1,120,2,0,200,25,2,Gateway Stake 54,82,200,25,2
Gateway Stake Centre ,Gateway Stake,25,1,2,1,174,230,3,Gateway Stake 55,82,174,230,3
Bearspaw Chapel,Gateway Stake,36,15,2,2,177,22,4,Gateway Stake 56,82,177,22,4
Riverbend Stake Centre,Riverbend Stake,4,45,2,2,210,24,4,Riverbend Stake 22,94,210,24,4
Gateway Stake Centre ,Gateway Stake,Ekota 13,1,2,2,120,40,4,Gateway Stake 57,82,120,40,4
Riverbend Stake Centre,Riverbend Stake,41,1,1,1,40,40,2,Riverbend Stake 23,94,40,40,2
Bearspaw Chapel,Gateway Stake,2,45,2,3,219,28,5,Gateway Stake 58,82,219,28,5
Londonberry Chapel,Bonnie Doon Stake,47,45,1,0,200,22,1,Bonnie Doon Stake 48,104,200,22,1
Gateway Stake Centre ,Gateway Stake,49,45,2,4,125,33,6,Gateway Stake 59,82,125,33,6
Gateway Stake Centre ,Gateway Stake,43,1,6,4,250,30,10,Gateway Stake 60,82,250,30,10
Londonberry Chapel,Bonnie Doon Stake,"209,200,220",45,3,0,200,33,3,Bonnie Doon Stake 49,104,200,33,3
Edmonton North Stake Centre,Edmonton North Stake,O rRNA A  and ozerna B,45,4,0,500,500,4,Edmonton North Stake 15,41,500,500,4
Londonberry Chapel,Bonnie Doon Stake,31,15,2,0,96,7,2,Bonnie Doon Stake 50,104,96,7,2
Bonnie Doon Stake Centre,Bonnie Doon Stake,106,45,2,0,104,13,2,Bonnie Doon Stake 51,104,104,13,2
Gateway Stake Centre ,Gateway Stake,42,45,3,2,123,38,5,Gateway Stake 61,82,123,38,5
Gateway Stake Centre ,Gateway Stake,56 Daly Grove,15,1,0,135,17,1,Gateway Stake 62,82,135,17,1
Gateway Stake Centre ,Gateway Stake,7,45,3,2,168,20,5,Gateway Stake 63,82,168,20,5
Bearspaw Chapel,Bonnie Doon Stake,M1,45,2,0,143,20,2,Bonnie Doon Stake 52,104,143,20,2
Bearspaw Chapel,Gateway Stake,12,1,2,4,200,20,6,Gateway Stake 64,82,200,20,6
Londonberry Chapel,Bonnie Doon Stake,5,45,2,2,17,17,4,Bonnie Doon Stake 53,104,17,17,4
Gateway Stake Centre ,Gateway Stake,39,15,2,0,110,50,2,Gateway Stake 65,82,110,50,2
Bonnie Doon Stake Centre,Bonnie Doon Stake,Bonnie Doon 3,1,3,0,192,11,3,Bonnie Doon Stake 54,104,192,11,3
Edmonton North Stake Centre,Edmonton North Stake,Wellington C,15,1,0,1,1,1,Edmonton North Stake 16,41,1,1,1
Riverbend Stake Centre,Riverbend Stake,Royal gardens. 3,45,4,0,150,17,4,Riverbend Stake 24,94,150,17,4
Gateway Stake Centre ,Gateway Stake,24,15,3,1,170,9,4,Gateway Stake 66,82,170,9,4
Gateway Stake Centre ,Gateway Stake,16,1,2,0,478,30,2,Gateway Stake 67,82,478,30,2
Bearspaw Chapel,Gateway Stake,7,45,2,2,30,40,4,Gateway Stake 68,82,30,40,4
Londonberry Chapel,Bonnie Doon Stake,6,45,1,1,24,30,2,Bonnie Doon Stake 55,104,24,30,2
Gateway Stake Centre ,Gateway Stake,42,15,4,1,80,31,5,Gateway Stake 69,82,80,31,5
Gateway Stake Centre ,Gateway Stake,33,15,2,3,35,6,5,Gateway Stake 70,82,35,6,5
Bearspaw Chapel,Gateway Stake,4,120,2,0,142,20,2,Gateway Stake 71,82,142,20,2
Riverbend Stake Centre,Riverbend Stake,50,1,2,1,205,34,3,Riverbend Stake 25,94,205,34,3
Bonnie Doon Stake Centre,Bonnie Doon Stake,King Edward Park 3,45,2,0,235,21,2,Bonnie Doon Stake 56,104,235,21,2
Bearspaw Chapel,Gateway Stake,162,1,1,4,166,32,5,Gateway Stake 72,82,166,32,5
Bonnie Doon Stake Centre,Bonnie Doon Stake,4,1,2,0,200,20,2,Bonnie Doon Stake 57,104,200,20,2
Bonnie Doon Stake Centre,Bonnie Doon Stake,Capilano #1,45,2,0,225,30,2,Bonnie Doon Stake 58,104,225,30,2
Londonberry Chapel,Bonnie Doon Stake,101,1,2,2,0,24,4,Bonnie Doon Stake 59,104,0,24,4
Gateway Stake Centre ,Gateway Stake,47,45,1,2,100,50,3,Gateway Stake 73,82,100,50,3
Bearspaw Chapel,Gateway Stake,43,45,2,0,30,20,2,Gateway Stake 74,82,30,20,2
Riverbend Stake Centre,Riverbend Stake,24,15,3,2,204,26,5,Riverbend Stake 26,94,204,26,5
Gateway Stake Centre ,Gateway Stake,10,1,2,0,239,24,2,Gateway Stake 75,82,239,24,2
Riverbend Stake Centre,Riverbend Stake,Brookside 3,15,2,0,95,15,2,Riverbend Stake 27,94,95,15,2
Bearspaw Chapel,YSA Stake,0,15,2,0,153,8,2,YSA Stake 4,3,153,8,2
Bearspaw Chapel,Bonnie Doon Stake,8,15,2,2,108,15,4,Bonnie Doon Stake 60,104,108,15,4
Bearspaw Chapel,Gateway Stake,12,120,2,0,143,43,2,Gateway Stake 76,82,143,43,2
Bonnie Doon Stake Centre,Bonnie Doon Stake,Fulton place #3 (poll 73),1,3,4,160,35,7,Bonnie Doon Stake 61,104,160,35,7
Gateway Stake Centre ,Gateway Stake,63,1,2,2,265,30,4,Gateway Stake 77,82,265,30,4
Bearspaw Chapel,Gateway Stake,27,1,2,3,260,32,5,Gateway Stake 78,82,260,32,5
Londonberry Chapel,Bonnie Doon Stake,212,1,2,2,110,30,4,Bonnie Doon Stake 62,104,110,30,4
Bearspaw Chapel,Bonnie Doon Stake,D4,120,2,0,123,15,2,Bonnie Doon Stake 63,104,123,15,2
Riverbend Stake Centre,Riverbend Stake,1&2,1,1,1,350,47,2,Riverbend Stake 28,94,350,47,2
Bonnie Doon Stake Centre,Bonnie Doon Stake,Fulton Place #2 poll 64,1,2,4,225,22,6,Bonnie Doon Stake 64,104,225,22,6
Edmonton North Stake Centre,Edmonton North Stake,Griesbach a and b,45,1,2,650,48,3,Edmonton North Stake 17,41,650,48,3
Gateway Stake Centre ,Gateway Stake,7,45,2,2,140,30,4,Gateway Stake 79,82,140,30,4
Bearspaw Chapel,Gateway Stake,54,45,1,1,145,26,2,Gateway Stake 80,82,145,26,2
Bearspaw Chapel,Gateway Stake,4,1,2,0,210,18,2,Gateway Stake 81,82,210,18,2
Londonberry Chapel,Bonnie Doon Stake,154,15,2,1,60,16,3,Bonnie Doon Stake 65,104,60,16,3
Bonnie Doon Stake Centre,Bonnie Doon Stake,#8,45,2,1,150,22,3,Bonnie Doon Stake 66,104,150,22,3
Londonberry Chapel,Bonnie Doon Stake,129,15,2,0,9,9,2,Bonnie Doon Stake 67,104,9,9,2
Riverbend Stake Centre,Riverbend Stake,7 Herb madlung,45,2,0,167,25,2,Riverbend Stake 29,94,167,25,2
Bearspaw Chapel,Gateway Stake,0,120,2,4,190,20,6,Gateway Stake 82,82,190,20,6
Londonberry Chapel,Bonnie Doon Stake,212,1,2,2,110,30,4,Bonnie Doon Stake 68,104,110,30,4
Riverbend Stake Centre,Riverbend Stake,55,1,2,0,174,17,2,Riverbend Stake 30,94,174,17,2
Bonnie Doon Stake Centre,Bonnie Doon Stake,Ritchie 1,45,2,0,212,16,2,Bonnie Doon Stake 69,104,212,16,2
Gateway Stake Centre ,Gateway Stake,20,1,2,0,150,20,2,Gateway Stake 83,82,150,20,2
Riverbend Stake Centre,Riverbend Stake,39,15,2,3,195,16,5,Riverbend Stake 31,94,195,16,5
Bearspaw Chapel,Gateway Stake,10,15,3,0,100,27,3,Gateway Stake 84,82,100,27,3
Riverbend Stake Centre,Riverbend Stake,Butchike,15,2,2,100,9,4,Riverbend Stake 32,94,100,9,4
Bonnie Doon Stake Centre,Bonnie Doon Stake,Ottewell 7,45,2,0,147,23,2,Bonnie Doon Stake 70,104,147,23,2
Londonberry Chapel,Bonnie Doon Stake,10,15,1,2,6,7,3,Bonnie Doon Stake 71,104,6,7,3
Gateway Stake Centre ,Gateway Stake,37,45,2,0,246,30,2,Gateway Stake 85,82,246,30,2
Gateway Stake Centre ,Gateway Stake,18,45,2,3,131,25,5,Gateway Stake 86,82,131,25,5
Riverbend Stake Centre,Riverbend Stake,47,15,2,2,172,16,4,Riverbend Stake 33,94,172,16,4
Edmonton North Stake Centre,Edmonton North Stake,Evansdale f ,45,4,0,301,19,4,Edmonton North Stake 18,41,301,19,4
Gateway Stake Centre ,Gateway Stake,18,1,2,0,236,40,2,Gateway Stake 87,82,236,40,2
Bearspaw Chapel,Gateway Stake,9,15,1,4,19,22,5,Gateway Stake 88,82,19,22,5
Riverbend Stake Centre,Riverbend Stake,Sweetgrass 2,45,2,4,120,16,6,Riverbend Stake 34,94,120,16,6
Bearspaw Chapel,Bonnie Doon Stake,Ld2,1,2,0,300,56,2,Bonnie Doon Stake 72,104,300,56,2
Gateway Stake Centre ,Gateway Stake,6,1,5,2,27,31,7,Gateway Stake 89,82,27,31,7
Gateway Stake Centre ,Gateway Stake,2,45,1,3,236,32,4,Gateway Stake 90,82,236,32,4
Bearspaw Chapel,Gateway Stake,7,15,3,0,90,30,3,Gateway Stake 91,82,90,30,3
Riverbend Stake Centre,Riverbend Stake,32/Todd Coleman,1,4,3,145,21,7,Riverbend Stake 35,94,145,21,7
Riverbend Stake Centre,Riverbend Stake,16,45,6,3,171,50,9,Riverbend Stake 36,94,171,50,9
Edmonton North Stake Centre,Edmonton North Stake,4-3.2,45,1,1,240,31,2,Edmonton North Stake 19,41,240,31,2
Riverbend Stake Centre,Riverbend Stake,60,120,2,1,223,100,3,Riverbend Stake 37,94,223,100,3
Londonberry Chapel,Bonnie Doon Stake,199,1,1,2,160,19,3,Bonnie Doon Stake 73,104,160,19,3
Bearspaw Chapel,Gateway Stake,46,120,2,4,186,21,6,Gateway Stake 92,82,186,21,6
Gateway Stake Centre ,Gateway Stake,32,45,2,2,200,30,4,Gateway Stake 93,82,200,30,4
Riverbend Stake Centre,Riverbend Stake,Stewarts,1,2,2,500,58,4,Riverbend Stake 38,94,500,58,4
Londonberry Chapel,Bonnie Doon Stake,169,15,2,1,126,9,3,Bonnie Doon Stake 74,104,126,9,3
Bearspaw Chapel,Gateway Stake,68,1,1,2,147,36,3,Gateway Stake 94,82,147,36,3
Gateway Stake Centre ,Gateway Stake,65,45,2,0,137,28,2,Gateway Stake 95,82,137,28,2
Bearspaw Chapel,Bonnie Doon Stake,LD1,1,2,4,158,35,6,Bonnie Doon Stake 75,104,158,35,6
Londonberry Chapel,Bonnie Doon Stake,160,1,2,0,19,19,2,Bonnie Doon Stake 76,104,19,19,2
Gateway Stake Centre ,Gateway Stake,31/lee ridge,15,3,0,175,30,3,Gateway Stake 96,82,175,30,3
Riverbend Stake Centre,Riverbend Stake,197,45,2,2,197,45,4,Riverbend Stake 39,94,197,45,4
Edmonton North Stake Centre,Edmonton North Stake,Caernarvon C,15,1,3,96,16,4,Edmonton North Stake 20,41,96,16,4
Riverbend Stake Centre,Riverbend Stake,lymburn 5,1,5,0,326,53,5,Riverbend Stake 40,94,326,53,5
Riverbend Stake Centre,Riverbend Stake,4,45,2,0,139,19,2,Riverbend Stake 41,94,139,19,2
Londonberry Chapel,Bonnie Doon Stake,184,15,1,1,300,27,2,Bonnie Doon Stake 77,104,300,27,2
Gateway Stake Centre ,Gateway Stake,90 street sw,120,2,6,300,50,8,Gateway Stake 97,82,300,50,8
Bonnie Doon Stake Centre,Bonnie Doon Stake,1,45,1,0,50,10,1,Bonnie Doon Stake 78,104,50,10,1
Bearspaw Chapel,Gateway Stake,0,1,1,2,0,45,3,Gateway Stake 98,82,0,45,3
Riverbend Stake Centre,Riverbend Stake,46,1,3,0,350,45,3,Riverbend Stake 42,94,350,45,3
Gateway Stake Centre ,Gateway Stake,29,1,4,1,203,30,5,Gateway Stake 99,82,203,30,5
Londonberry Chapel,Bonnie Doon Stake,8,45,2,0,31,39,2,Bonnie Doon Stake 79,104,31,39,2
Londonberry Chapel,Bonnie Doon Stake,23,1,2,0,50,40,2,Bonnie Doon Stake 80,104,50,40,2
Gateway Stake Centre ,Gateway Stake,39,1,2,1,176,20,3,Gateway Stake 100,82,176,20,3
Riverbend Stake Centre,Riverbend Stake,"18,19",1,3,1,354,59,4,Riverbend Stake 43,94,354,59,4
Gateway Stake Centre ,Gateway Stake,70,45,2,2,100,12,4,Gateway Stake 101,82,100,12,4
Bonnie Doon Stake Centre,Bonnie Doon Stake,goldbar 1,120,1,2,185,25,3,Bonnie Doon Stake 81,104,185,25,3
Londonberry Chapel,Bonnie Doon Stake,19,1,2,0,30,40,2,Bonnie Doon Stake 82,104,30,40,2
Gateway Stake Centre ,Gateway Stake,30,45,2,0,174,25,2,Gateway Stake 102,82,174,25,2
Riverbend Stake Centre,Riverbend Stake,Brookside 1,15,1,5,66,12,6,Riverbend Stake 44,94,66,12,6
Gateway Stake Centre ,Gateway Stake,10,120,3,8,400,41,11,Gateway Stake 103,82,400,41,11
Edmonton North Stake Centre,Edmonton North Stake,Caernarvon B,120,2,0,160,32,2,Edmonton North Stake 21,41,160,32,2
Riverbend Stake Centre,Riverbend Stake,Ag2,1,2,3,209,80,5,Riverbend Stake 45,94,209,80,5
Gateway Stake Centre ,Gateway Stake,56 Daly Grove,15,1,0,138,4,1,Gateway Stake 104,82,138,4,1
Londonberry Chapel,Bonnie Doon Stake,128,45,0,2,0,30,2,Bonnie Doon Stake 83,104,0,30,2
Bonnie Doon Stake Centre,Bonnie Doon Stake,Ottewell 8,1,2,0,242,46,2,Bonnie Doon Stake 84,104,242,46,2
Bonnie Doon Stake Centre,Bonnie Doon Stake,1,45,2,0,150,25,2,Bonnie Doon Stake 85,104,150,25,2
Londonberry Chapel,Bonnie Doon Stake,39,45,2,9,20,26,11,Bonnie Doon Stake 86,104,20,26,11
Riverbend Stake Centre,Riverbend Stake,12,1,4,0,346,73,4,Riverbend Stake 46,94,346,73,4
Edmonton North Stake Centre,Edmonton North Stake,3-1.1a,1,3,0,135,14,3,Edmonton North Stake 22,41,135,14,3
Riverbend Stake Centre,Riverbend Stake,10,45,4,0,250,54,4,Riverbend Stake 47,94,250,54,4
Gateway Stake Centre ,Gateway Stake,44,1,1,2,166,24,3,Gateway Stake 105,82,166,24,3
Gateway Stake Centre ,Gateway Stake,44,15,1,1,200,58,2,Gateway Stake 106,82,200,58,2
Gateway Stake Centre ,Gateway Stake,15,45,3,2,207,36,5,Gateway Stake 107,82,207,36,5
Riverbend Stake Centre,Riverbend Stake,18,15,4,4,100,25,8,Riverbend Stake 48,94,100,25,8
Riverbend Stake Centre,Riverbend Stake,15,45,4,1,60,14,5,Riverbend Stake 49,94,60,14,5
Riverbend Stake Centre,Riverbend Stake,45,1,1,4,250,56,5,Riverbend Stake 50,94,250,56,5
Gateway Stake Centre ,Gateway Stake,"5,8",1,1,1,100,30,2,Gateway Stake 108,82,100,30,2
Gateway Stake Centre ,Gateway Stake,46,45,2,4,264,35,6,Gateway Stake 109,82,264,35,6
Londonberry Chapel,Bonnie Doon Stake,205,1,1,0,65,70,1,Bonnie Doon Stake 87,104,65,70,1
Londonberry Chapel,Bonnie Doon Stake,138,120,2,0,49,73,2,Bonnie Doon Stake 88,104,49,73,2
Gateway Stake Centre ,Gateway Stake,32,45,2,2,205,10,4,Gateway Stake 110,82,205,10,4
Riverbend Stake Centre,Riverbend Stake,42,1,2,0,160,42,2,Riverbend Stake 51,94,160,42,2
Edmonton North Stake Centre,Edmonton North Stake,3-2.2B,45,2,1,106,23,3,Edmonton North Stake 23,41,106,23,3
Riverbend Stake Centre,Riverbend Stake,49,1,3,0,195,29,3,Riverbend Stake 52,94,195,29,3
Gateway Stake Centre ,Gateway Stake,36,1,2,1,140,20,3,Gateway Stake 111,82,140,20,3
Bearspaw Chapel,Riverbend Stake,Ld7,1,2,4,127,58,6,Riverbend Stake 53,94,127,58,6
Riverbend Stake Centre,Riverbend Stake,Terwiliger park,1,2,0,175,25,2,Riverbend Stake 54,94,175,25,2
Edmonton North Stake Centre,Edmonton North Stake,0,45,2,0,200,22,2,Edmonton North Stake 24,41,200,22,2
Riverbend Stake Centre,Riverbend Stake,38,1,4,9,171,26,13,Riverbend Stake 55,94,171,26,13
Gateway Stake Centre ,Gateway Stake,1,45,2,4,245,25,6,Gateway Stake 112,82,245,25,6
Bearspaw Chapel,Bonnie Doon Stake,3,120,2,2,150,46,4,Bonnie Doon Stake 89,104,150,46,4
Edmonton North Stake Centre,Edmonton North Stake,Carlisle C,45,2,0,150,16,2,Edmonton North Stake 25,41,150,16,2
Riverbend Stake Centre,Riverbend Stake,54,15,2,4,136,20,6,Riverbend Stake 56,94,136,20,6
Riverbend Stake Centre,Riverbend Stake,43 - ramsay heights,1,3,2,164,30,5,Riverbend Stake 57,94,164,30,5
Gateway Stake Centre ,Gateway Stake,13,1,2,4,300,75,6,Gateway Stake 113,82,300,75,6
Londonberry Chapel,Bonnie Doon Stake,205,1,1,0,225,80,1,Bonnie Doon Stake 90,104,225,80,1
Gateway Stake Centre ,Gateway Stake,28,45,2,3,230,42,5,Gateway Stake 114,82,230,42,5
Bearspaw Chapel,Gateway Stake,16,15,2,2,0,55,4,Gateway Stake 115,82,0,55,4
Gateway Stake Centre ,Gateway Stake,Satoo/route #s 3 & 5,1,1,1,312,150,2,Gateway Stake 116,82,312,150,2
Gateway Stake Centre ,Gateway Stake,55,45,2,2,159,15,4,Gateway Stake 117,82,159,15,4
Riverbend Stake Centre,Riverbend Stake,9,120,4,2,428,75,6,Riverbend Stake 58,94,428,75,6
Riverbend Stake Centre,Riverbend Stake,40,45,1,2,100,12,3,Riverbend Stake 59,94,100,12,3
Gateway Stake Centre ,Gateway Stake,16,15,1,5,239,32,6,Gateway Stake 118,82,239,32,6
Gateway Stake Centre ,Gateway Stake,6,120,2,0,400,50,2,Gateway Stake 119,82,400,50,2
Londonberry Chapel,Bonnie Doon Stake,135,45,2,2,90,17,4,Bonnie Doon Stake 91,104,90,17,4
Edmonton North Stake Centre,Edmonton North Stake,"Carlisle A, Carlisle B",45,3,0,300,24,3,Edmonton North Stake 26,41,300,24,3
Bearspaw Chapel,Gateway Stake,20,120,2,1,260,100,3,Gateway Stake 120,82,260,100,3
Londonberry Chapel,Bonnie Doon Stake,36,15,2,3,16,19,5,Bonnie Doon Stake 92,104,16,19,5
Londonberry Chapel,Bonnie Doon Stake,126,45,2,2,125,21,4,Bonnie Doon Stake 93,104,125,21,4
Riverbend Stake Centre,Riverbend Stake,Greenfield #5,1,1,1,184,45,2,Riverbend Stake 60,94,184,45,2
Riverbend Stake Centre,Riverbend Stake,8 and 11,120,1,3,600,118,4,Riverbend Stake 61,94,600,118,4
Gateway Stake Centre ,Gateway Stake,21,1,1,2,134,30,3,Gateway Stake 121,82,134,30,3
Gateway Stake Centre ,Gateway Stake,79/194bags,45,2,0,270,50,2,Gateway Stake 122,82,270,50,2
Riverbend Stake Centre,Riverbend Stake,"30, 28, 43",1,3,2,500,65,5,Riverbend Stake 62,94,500,65,5
Gateway Stake Centre ,Gateway Stake,22,1,1,0,138,6,1,Gateway Stake 123,82,138,6,1
Gateway Stake Centre ,Gateway Stake,65,15,2,2,119,14,4,Gateway Stake 124,82,119,14,4
Riverbend Stake Centre,Riverbend Stake,Unkown,45,5,0,326,53,5,Riverbend Stake 63,94,326,53,5
Edmonton North Stake Centre,Edmonton North Stake,grey stone manor,45,2,2,70,7,4,Edmonton North Stake 27,41,70,7,4
Gateway Stake Centre ,Gateway Stake,43 and 44,45,4,0,278,35,4,Gateway Stake 125,82,278,35,4
Riverbend Stake Centre,Riverbend Stake,50,45,3,0,329,15,3,Riverbend Stake 64,94,329,15,3
Bearspaw Chapel,Gateway Stake,32,45,1,1,152,30,2,Gateway Stake 126,82,152,30,2
Riverbend Stake Centre,Riverbend Stake,Blue quill estate 2,45,2,3,210,25,5,Riverbend Stake 65,94,210,25,5
Londonberry Chapel,Bonnie Doon Stake,120,15,2,1,18,25,3,Bonnie Doon Stake 94,104,18,25,3
Gateway Stake Centre ,Gateway Stake,27,45,2,3,205,25,5,Gateway Stake 127,82,205,25,5
Gateway Stake Centre ,Gateway Stake,4,15,3,0,168,25,3,Gateway Stake 128,82,168,25,3
Gateway Stake Centre ,Gateway Stake,12,1,2,5,216,46,7,Gateway Stake 129,82,216,46,7
Edmonton North Stake Centre,Edmonton North Stake,6-2.1 197,120,1,4,100,18,5,Edmonton North Stake 28,41,100,18,5
Riverbend Stake Centre,Riverbend Stake,Sweet grass 3,45,2,4,200,49,6,Riverbend Stake 66,94,200,49,6
Bonnie Doon Stake Centre,Bonnie Doon Stake,77,120,3,0,200,30,3,Bonnie Doon Stake 95,104,200,30,3
Bearspaw Chapel,Gateway Stake,1,1,2,2,410,45,4,Gateway Stake 130,82,410,45,4
Gateway Stake Centre ,Gateway Stake,66,1,1,2,146,25,3,Gateway Stake 131,82,146,25,3
Riverbend Stake Centre,Riverbend Stake,14,1,1,2,262,40,3,Riverbend Stake 67,94,262,40,3
Bonnie Doon Stake Centre,Bonnie Doon Stake,Ottewell 1,15,2,3,241,23,5,Bonnie Doon Stake 96,104,241,23,5
Edmonton North Stake Centre,Edmonton North Stake,2-1.1,120,2,2,498,55,4,Edmonton North Stake 29,41,498,55,4
Bonnie Doon Stake Centre,Bonnie Doon Stake,36,15,4,0,167,30,4,Bonnie Doon Stake 97,104,167,30,4
Bonnie Doon Stake Centre,Bonnie Doon Stake,63,1,2,1,25,12,3,Bonnie Doon Stake 98,104,25,12,3
Bearspaw Chapel,Gateway Stake,21,45,2,3,240,35,5,Gateway Stake 132,82,240,35,5
Riverbend Stake Centre,Riverbend Stake,Greenfield #1,45,2,0,150,34,2,Riverbend Stake 68,94,150,34,2
Gateway Stake Centre ,Gateway Stake,17,45,2,1,500,62,3,Gateway Stake 133,82,500,62,3
Bonnie Doon Stake Centre,Bonnie Doon Stake,Ottewell 5,15,2,3,209,15,5,Bonnie Doon Stake 99,104,209,15,5
Riverbend Stake Centre,Riverbend Stake,17,120,2,4,312,60,6,Riverbend Stake 69,94,312,60,6
Gateway Stake Centre ,Gateway Stake,75,45,2,1,149,25,3,Gateway Stake 134,82,149,25,3
Bonnie Doon Stake Centre,Bonnie Doon Stake,Avonmore 1,15,4,0,167,25,4,Bonnie Doon Stake 100,104,167,25,4
Bonnie Doon Stake Centre,Bonnie Doon Stake,King Edward Park 1,120,1,0,522,80,1,Bonnie Doon Stake 101,104,522,80,1
Edmonton North Stake Centre,Edmonton North Stake,Wellington ABCD,120,3,0,800,66,3,Edmonton North Stake 30,41,800,66,3
Gateway Stake Centre ,Gateway Stake,40,45,1,0,115,7,1,Gateway Stake 135,82,115,7,1
Riverbend Stake Centre,Riverbend Stake,4,45,2,4,250,47,6,Riverbend Stake 70,94,250,47,6
Riverbend Stake Centre,Riverbend Stake,"65, 67, 68",45,2,0,282,54,2,Riverbend Stake 71,94,282,54,2
Riverbend Stake Centre,Riverbend Stake,BQ5,1,2,3,180,42,5,Riverbend Stake 72,94,180,42,5
Bearspaw Chapel,Gateway Stake,28,1,3,4,377,71,7,Gateway Stake 136,82,377,71,7
Riverbend Stake Centre,Riverbend Stake,63,1,2,2,101,19,4,Riverbend Stake 73,94,101,19,4
Londonberry Chapel,Bonnie Doon Stake,138,15,2,1,0,5,3,Bonnie Doon Stake 102,104,0,5,3
Gateway Stake Centre ,Gateway Stake,40,15,2,0,140,17,2,Gateway Stake 137,82,140,17,2
Edmonton North Stake Centre,Edmonton North Stake,Dovercourt C,45,2,5,142,20,7,Edmonton North Stake 31,41,142,20,7
Londonberry Chapel,Bonnie Doon Stake,1,45,1,1,8,10,2,Bonnie Doon Stake 103,104,8,10,2
Riverbend Stake Centre,Riverbend Stake,Greenfield 6,45,2,3,211,37,5,Riverbend Stake 74,94,211,37,5
Bearspaw Chapel,Gateway Stake,35,45,2,3,200,25,5,Gateway Stake 138,82,200,25,5
Bonnie Doon Stake Centre,Bonnie Doon Stake,Poll 81,15,2,2,225,20,4,Bonnie Doon Stake 104,104,225,20,4
Riverbend Stake Centre,Riverbend Stake,Blue quill1,45,2,0,500,38,2,Riverbend Stake 75,94,500,38,2
Riverbend Stake Centre,Riverbend Stake,20,1,2,4,300,50,6,Riverbend Stake 76,94,300,50,6
Bearspaw Chapel,Gateway Stake,67,15,4,0,155,21,4,Gateway Stake 139,82,155,21,4
Gateway Stake Centre ,Gateway Stake,76,45,2,0,171,12,2,Gateway Stake 140,82,171,12,2
Riverbend Stake Centre,Riverbend Stake,55,1,3,1,192,37,4,Riverbend Stake 77,94,192,37,4
Riverbend Stake Centre,Riverbend Stake,17,1,3,0,215,38,3,Riverbend Stake 78,94,215,38,3
Gateway Stake Centre ,Gateway Stake,13,45,3,4,188,27,7,Gateway Stake 141,82,188,27,7
Riverbend Stake Centre,Riverbend Stake,51,1,2,0,302,65,2,Riverbend Stake 79,94,302,65,2
Riverbend Stake Centre,Riverbend Stake,22,1,2,2,360,30,4,Riverbend Stake 80,94,360,30,4
Edmonton North Stake Centre,Edmonton North Stake,5.6,1,5,10,800,95,15,Edmonton North Stake 32,41,800,95,15
Riverbend Stake Centre,Riverbend Stake,26/27,1,2,3,300,40,5,Riverbend Stake 81,94,300,40,5
Riverbend Stake Centre,Riverbend Stake,25,1,4,2,289,55,6,Riverbend Stake 82,94,289,55,6
Gateway Stake Centre ,Gateway Stake,55,45,1,3,151,34,4,Gateway Stake 142,82,151,34,4
Edmonton North Stake Centre,Edmonton North Stake,Stacey Williams ,120,2,0,800,57,2,Edmonton North Stake 33,41,800,57,2
Londonberry Chapel,Bonnie Doon Stake,27,45,2,0,40,3,2,Bonnie Doon Stake 105,104,40,3,2
Riverbend Stake Centre,Riverbend Stake,Blue quill 3,45,2,2,200,42,4,Riverbend Stake 83,94,200,42,4
Riverbend Stake Centre,Riverbend Stake,12,45,2,2,300,35,4,Riverbend Stake 84,94,300,35,4
Gateway Stake Centre ,Gateway Stake,34,1,2,2,257,31,4,Gateway Stake 143,82,257,31,4
Edmonton North Stake Centre,Edmonton North Stake,5-1.2,45,1,1,433,39,2,Edmonton North Stake 34,41,433,39,2
Riverbend Stake Centre,Riverbend Stake,54,120,1,2,182,43,3,Riverbend Stake 85,94,182,43,3
Gateway Stake Centre ,Gateway Stake,22,1,1,4,300,40,5,Gateway Stake 144,82,300,40,5
Edmonton North Stake Centre,Edmonton North Stake,Caernarvon D,15,1,2,212,20,3,Edmonton North Stake 35,41,212,20,3
Edmonton North Stake Centre,Edmonton North Stake,2-3.1,120,2,2,400,123,4,Edmonton North Stake 36,41,400,123,4
Riverbend Stake Centre,Riverbend Stake,26,15,2,0,132,16,2,Riverbend Stake 86,94,132,16,2
Londonberry Chapel,Bonnie Doon Stake,20,120,3,0,50,50,3,Bonnie Doon Stake 106,104,50,50,3
Gateway Stake Centre ,Gateway Stake,47,45,1,4,245,28,5,Gateway Stake 145,82,245,28,5
Gateway Stake Centre ,Gateway Stake,40,45,2,1,160,29,3,Gateway Stake 146,82,160,29,3
Londonberry Chapel,Bonnie Doon Stake,23,15,2,0,131,9,2,Bonnie Doon Stake 107,104,131,9,2
Riverbend Stake Centre,Riverbend Stake,3,1,2,0,150,41,2,Riverbend Stake 87,94,150,41,2
Edmonton North Stake Centre,Edmonton North Stake,Lori lie D,45,3,4,32,30,7,Edmonton North Stake 37,41,32,30,7
Londonberry Chapel,Bonnie Doon Stake,121,120,1,1,150,45,2,Bonnie Doon Stake 108,104,150,45,2
Riverbend Stake Centre,Riverbend Stake,Brayden Gregson,120,3,0,1030,100,3,Riverbend Stake 88,94,1030,100,3
Gateway Stake Centre ,Gateway Stake,11,15,3,0,233,30,3,Gateway Stake 147,82,233,30,3
Gateway Stake Centre ,Gateway Stake,5,1,2,2,180,20,4,Gateway Stake 148,82,180,20,4
Riverbend Stake Centre,Riverbend Stake,Westbrook,1,2,3,219,50,5,Riverbend Stake 89,94,219,50,5
Londonberry Chapel,Bonnie Doon Stake,28,15,2,0,15,12,2,Bonnie Doon Stake 109,104,15,12,2
Riverbend Stake Centre,Riverbend Stake,9. C 283,1,2,0,283,51,2,Riverbend Stake 90,94,283,51,2
Riverbend Stake Centre,Riverbend Stake,44,1,2,1,175,40,3,Riverbend Stake 91,94,175,40,3
Riverbend Stake Centre,Riverbend Stake,72,120,1,5,132,22,6,Riverbend Stake 92,94,132,22,6
Riverbend Stake Centre,Riverbend Stake,19,1,2,3,350,49,5,Riverbend Stake 93,94,350,49,5
Gateway Stake Centre ,Gateway Stake,81,120,2,4,730,64,6,Gateway Stake 149,82,730,64,6
Riverbend Stake Centre,Riverbend Stake,42,45,1,0,150,20,1,Riverbend Stake 94,94,150,20,1
Gateway Stake Centre ,Gateway Stake,38,1,2,2,339,40,4,Gateway Stake 150,82,339,40,4
Riverbend Stake Centre,Riverbend Stake,60,120,2,1,181,60,3,Riverbend Stake 95,94,181,60,3
Gateway Stake Centre ,Gateway Stake,59,45,1,1,146,22,2,Gateway Stake 151,82,146,22,2
Gateway Stake Centre ,Gateway Stake,14,45,2,0,225,30,2,Gateway Stake 152,82,225,30,2
Riverbend Stake Centre,Riverbend Stake,I dont remember,15,2,3,142,23,5,Riverbend Stake 96,94,142,23,5
Edmonton North Stake Centre,Edmonton North Stake,Belle Rive B C D E F ,120,2,0,950,133,2,Edmonton North Stake 38,41,950,133,2
Riverbend Stake Centre,Riverbend Stake,Sweetgrass 1,45,2,4,100,28,6,Riverbend Stake 97,94,100,28,6
Bearspaw Chapel,Gateway Stake,11,1,4,4,11,16,8,Gateway Stake 153,82,11,16,8
Bearspaw Chapel,Gateway Stake,41,1,4,4,158,24,8,Gateway Stake 154,82,158,24,8
Gateway Stake Centre ,Gateway Stake,66,120,1,0,260,200,1,Gateway Stake 155,82,260,200,1
Bearspaw Chapel,Gateway Stake,28 Lee ridge,1,2,0,159,29,2,Gateway Stake 156,82,159,29,2
Bearspaw Chapel,Gateway Stake,12,1,4,4,153,25,8,Gateway Stake 157,82,153,25,8
Gateway Stake Centre ,Gateway Stake,57,1,2,2,126,20,4,Gateway Stake 158,82,126,20,4
Gateway Stake Centre ,Gateway Stake,14,45,3,4,206,32,7,Gateway Stake 159,82,206,32,7
Gateway Stake Centre ,Gateway Stake,15,45,3,4,202,27,7,Gateway Stake 160,82,202,27,7
Edmonton North Stake Centre,Edmonton North Stake,Sherbrooke D,1,3,1,313,45,4,Edmonton North Stake 39,41,313,45,4
Edmonton North Stake Centre,Edmonton North Stake,Sherbrooke B,15,3,1,140,18,4,Edmonton North Stake 40,41,140,18,4
Edmonton North Stake Centre,Edmonton North Stake,Caernarvon E,1,3,0,300,47,3,Edmonton North Stake 41,41,300,47,3
Edmonton North Stake Centre,Edmonton North Stake,Wellington EF,45,1,4,200,40,5,Edmonton North Stake 42,41,200,40,5
Edmonton North Stake Centre,Edmonton North Stake,2-2.4,1,1,0,151,16,1,Edmonton North Stake 43,41,151,16,1
Bearspaw Chapel,Gateway Stake,38,15,2,4,169,18,6,Gateway Stake 161,82,169,18,6
Bearspaw Chapel,Gateway Stake,33,15,4,4,165,23,8,Gateway Stake 162,82,165,23,8
Bearspaw Chapel,Gateway Stake,34,15,4,4,166,10,8,Gateway Stake 163,82,166,10,8
Bearspaw Chapel,Gateway Stake,37,15,2,4,163,17,6,Gateway Stake 164,82,163,17,6
Bearspaw Chapel,Gateway Stake,47,15,2,2,95,20,4,Gateway Stake 165,82,95,20,4
Bonnie Doon Stake Centre,Bonnie Doon Stake,98 & 101 Av,45,1,0,40,15,1,Bonnie Doon Stake 110,104,40,15,1
Bonnie Doon Stake Centre,Bonnie Doon Stake,Argyl 2,45,2,1,150,15,3,Bonnie Doon Stake 111,104,150,15,3
Bonnie Doon Stake Centre,Bonnie Doon Stake,Ottowell 3,15,1,2,100,15,3,Bonnie Doon Stake 112,104,100,15,3
Bonnie Doon Stake Centre,Bonnie Doon Stake,76 Av - 96th,1,2,0,50,15,2,Bonnie Doon Stake 113,104,50,15,2
Bonnie Doon Stake Centre,Bonnie Doon Stake,101 St - 84 Av - 97 St - 85 Av - 99 St,15,1,0,50,20,1,Bonnie Doon Stake 114,104,50,20,1
Bonnie Doon Stake Centre,Bonnie Doon Stake,King Edward Park 3,45,1,0,235,21,1,Bonnie Doon Stake 115,104,235,21,1
Bonnie Doon Stake Centre,Bonnie Doon Stake,Riverdale 2,45,1,0,200,100,1,Bonnie Doon Stake 116,104,200,100,1
Bearspaw Chapel,Bonnie Doon Stake,AD5,1,3,0,375,58,3,Bonnie Doon Stake 117,104,375,58,3
Bearspaw Chapel,Gateway Stake,7,45,2,0,175,30,2,Gateway Stake 166,82,175,30,2
Communities Outside Edmonton,Gateway Stake,7,120,2,0,99,11,2,Gateway Stake 167,82,99,11,2
Communities Outside Edmonton,Gateway Stake,15,120,2,0,153,13,2,Gateway Stake 168,82,153,13,2
Bonnie Doon Stake Centre,Bonnie Doon Stake,Strathcona 7,1,5,0,202,26,5,Bonnie Doon Stake 118,104,202,26,5
Riverbend Stake Centre,Riverbend Stake,Ogilvie Ridge both routes,1,2,3,200,60,5,Riverbend Stake 98,94,200,60,5
Riverbend Stake Centre,Riverbend Stake,Route 4,45,2,1,159,19,3,Riverbend Stake 99,94,159,19,3
Riverbend Stake Centre,Riverbend Stake,30,15,2,4,158,24,6,Riverbend Stake 100,94,158,24,6
Riverbend Stake Centre,Riverbend Stake,71 Twin Brooks,1,3,0,132,19,3,Riverbend Stake 101,94,132,19,3
Bearspaw Chapel,Riverbend Stake,Midbo,1,2,0,289,40,2,Riverbend Stake 102,94,289,40,2
Riverbend Stake Centre,Riverbend Stake,69 Twin Brooks,1,3,0,122,20,3,Riverbend Stake 103,94,122,20,3
Bearspaw Chapel,Gateway Stake,3,15,1,1,136,21,2,Gateway Stake 169,82,136,21,2
Bearspaw Chapel,Gateway Stake,26,15,1,1,166,8,2,Gateway Stake 170,82,166,8,2
Riverbend Stake Centre,Riverbend Stake,14,15,3,0,110,10,3,Riverbend Stake 104,94,110,10,3
Riverbend Stake Centre,Riverbend Stake,Henderson states #2,120,1,1,250,62,2,Riverbend Stake 105,94,250,62,2
Riverbend Stake Centre,Riverbend Stake,12,1,2,2,60,35,4,Riverbend Stake 106,94,60,35,4
Riverbend Stake Centre,Riverbend Stake,Royal Gardens #4,45,2,3,120,31,5,Riverbend Stake 107,94,120,31,5
Riverbend Stake Centre,Riverbend Stake,Aspen gardens ,1,2,3,200,100,5,Riverbend Stake 108,94,200,100,5
Riverbend Stake Centre,Riverbend Stake,Greenfield 7,45,2,0,211,47,2,Riverbend Stake 109,94,211,47,2
Riverbend Stake Centre,Riverbend Stake,70,15,2,1,58,6,3,Riverbend Stake 110,94,58,6,3
Bonnie Doon Stake Centre,Bonnie Doon Stake,King Edward Park 4,45,2,0,150,23,2,Bonnie Doon Stake 119,104,150,23,2
Riverbend Stake Centre,Riverbend Stake,Greenfield 3,1,1,0,140,33,1,Riverbend Stake 111,94,140,33,1
Riverbend Stake Centre,Riverbend Stake,56,1,3,0,121,45,3,Riverbend Stake 112,94,121,45,3